{
  "name": "tutorial",
  "author": "darkborderman",
  "source": null,
  "levels": [
    [
      "######",
      "#@X.O#",
      "######"
    ],
    [
      "#######",
      "###...#",
      "###.#.#",
      "#O....#",
      "###X###",
      "###@###",
      "#######"
    ]
  ]
}
