{
  "name": "Easy",
  "author": "darkborderman",
  "source": null,
  "levels": [
    [
      "#######",
      "#..OO##",
      "#.XX###",
      "##O@X.#",
      "##....#",
      "#######"
    ],
    [
      "######",
      "#.@.##",
      "#XXX##",
      "#O#..#",
      "#OO..#",
      "######"
    ],
    [
      "#######",
      "##OX..#",
      "#@XO..#",
      "#..XO##",
      "#######"
    ],
    [
      "######",
      "##O###",
      "##.O##",
      "#O.X##",
      "##XX@#",
      "##...#",
      "######"
    ],
    [
      "########",
      "##..####",
      "#...XO##",
      "#.OX#@##",
      "#...XO##",
      "##..####",
      "########"
    ],
    [
      "########",
      "###..###",
      "###..X.#",
      "#.OX.#.#",
      "#.X@.O.#",
      "#.O.OX.#",
      "########"
    ],
    [
      "########",
      "#.X.O@.#",
      "#.O#OX.#",
      "##O..X.#",
      "##X...##",
      "##..####",
      "########"
    ],
    [
      "#######",
      "#.X..O#",
      "#.O@OX#",
      "#.X...#",
      "###X.O#",
      "###..##",
      "#######"
    ],
    [
      "########",
      "###..###",
      "##O.X..#",
      "#.X..X.#",
      "#..OOX##",
      "#.XO@O##",
      "########"
    ],
    [
      "########",
      "###....#",
      "#.XXXX.#",
      "#...X..#",
      "##@OO.##",
      "###OOO##",
      "########"
    ],
    [
      "#########",
      "####...##",
      "##..X#.##",
      "##.#...@#",
      "##X..X###",
      "#..##O###",
      "#...OO###",
      "#########"
    ],
    [
      "########",
      "#.@..###",
      "#.XXX###",
      "#.XOOO##",
      "#.X.OO##",
      "########"
    ],
    [
      "#########",
      "#..OXO..#",
      "#..X@X..#",
      "#..OXO..#",
      "#########"
    ]
  ]
}
