{
  "name": "Medium",
  "author": "darkborderman",
  "source": null,
  "levels": [
    [
      "########",
      "#...####",
      "#.XXOO##",
      "#.XOX..#",
      "#.O@OX.#",
      "#.XOXO##",
      "###..###",
      "########"
    ],
    [
      "##########",
      "###O######",
      "###......#",
      "###..#X..#",
      "####O#..##",
      "#O##..XX##",
      "#...O.X.##",
      "#..##@..##",
      "##########"
    ],
    [
      "#######",
      "##.@.##",
      "##XXXO#",
      "#..X.##",
      "#..OOO#",
      "#..XO.#",
      "#######"
    ],
    [
      "########",
      "###...O#",
      "##.X.X.#",
      "##.O.X##",
      "##.#O.##",
      "#@..XO##",
      "###OX.##",
      "########"
    ],
    [
      "######",
      "#.X.O#",
      "#.#.##",
      "#...O#",
      "##XX##",
      "##@.O#",
      "######"
    ]
  ]
}
