{
	"name": "Easy",
	"levels": [
		[
			"######",
			"#.@.##",
			"#XXX##",
			"#O#..#",
			"#OO..#",
			"######"
		],
		[
			"#######",
			"##OX..#",
			"#@XO..#",
			"#..XO##",
			"#######"
		]
	]
}
