{
    "name": "Medium",
    "levels": [
        [
            "###########",
            "####O######",
            "####......#",
            "####..#X..#",
            "#####O#..##",
            "##O##..XX##",
            "##...O.X.##",
            "##..##@..##",
            "###########"
        ],
        [
            "#######",
            "##.@.##",
            "##XXXO#",
            "#..X.##",
            "#..OOO#",
            "#..XO.#",
            "#######"
        ]
    ]
}
