{
    "name": "Refactor",
    "levels": [
        [
            "######",
            "#.@.##",
            "#XXX##",
            "#O#..#",
            "#OO..#",
            "######"
        ]
    ]
}